IMAGE_NAME TileSheet.png
TILE_COUNT 4
GRID 10 10
1 1 1 1 1 1 1 1 1 1 
1 2 0 0 0 0 0 0 3 1
1 0 0 0 0 0 0 0 0 1 
1 0 0 0 0 0 0 0 0 1
1 0 0 0 0 0 0 0 0 1
1 0 0 0 0 0 0 0 0 1
1 0 0 0 0 0 0 0 0 1
1 0 0 0 0 0 0 0 0 1
1 2 0 0 0 0 0 0 3 1
1 1 1 1 1 1 1 1 1 1
